R 1280 720

SO ./sprites/wall1low.xpm
EA ./sprites/wall3low.xpm
NO ./sprites/wall2low.xpm
WE ./sprites/wall4low.xpm
F 30,31,32
C 90,150,255
S ./sprites/piper100.xpm


111111111111111111111111 
100000000000000000000001
100000000000000000000001
100000000000000000000001
100000000010100000000001 
100000000010100000000001 
100000011110111100000001 
100000000000000000000001 
100000011110111100000001 
100000000010100000000001 
100000000010100000000001 
100000000000000000000001
100000000000000000000001
100000000000000000000001
10000000000N000000000001
100000000000000000000001
111111111111111111111111