R 1920 1080

SO ./sprites/wall1low.xpm
EA ./sprites/wall3low.xpm
NO ./sprites/wall2low.xpm
WE ./sprites/wall4low.xpm
F 30,31,32
C 90,150,255
S ./sprites/piper100.xpm


0001p1111111100
001000000000100
010000000000100
100000000000100
100000000000100
100000000001000
100000000010000
111111111100000