R 1280 720

SO ./sprites/aidra100.xpm
EA ./sprites/piper.xpm
NO ./sprites/ouaf.xpm
WE ./sprites/karin.xpm
F 30,31,32
C 90,150,255
S ./sprites/piper100.xpm

SO ./sprites/aidra100.xpm

11111111111111111111111 
10000000000000000000001 
10000001111011110000001 
10000000001010000000001 
10000000001010000000001 
10100000000000000000101
10100000000000000000101
10111000000000000011101
10000000000N00000000001
10111000000000000011101
10100000000000000000101
10100000001010000000101 
10000000001010000000001 
10000001111011110000001 
10000000000000000000001 
11111111111111111111111