R 680 480

SO ./sprites/orr_SO.xpm
EA ./sprites/orr_EA.xpm
NO ./sprites/orr_NO.xpm
WE ./sprites/orr_WE.xpm
F 
C 90,150,255
S ./sprites/piper100.xpm


11111111111111111
10010000000001001
10100000000000101
11000000000000011
10000000000000001
10000000000000001
10000000000000001
10000000N00000001
10000000000000001
10000000000000001
10000000000000001
11000000000000011
10100000000000101
10010000000001001
11111111111111111