R 680 480

SO ./sprites/wall1low.xpm
EA ./sprites/wall3low.xpm
NO ./sprites/wall2low.xpm
WE ./sprites/wall4low.xpm
F 30,31,32
C 90,150,255
S ./sprites/piper100.xpm

1111111111 
1000100011 
1010101011 
1010101011 
1010101011 
1010101011 
1010101011 
1010101011 
1010001001 
1111111111