R 1280 720

SO ./sprites/WB.xpm
EA ./sprites/piper100.xpm
NO ./sprites/aidra100.xpm
WE ./sprites/sakura.xpm
F 130,230,132
C 99,0,255
S ./sprites/123456.xpm

11111111111111111111111111111111111111111111111111
10000000000000000000000000000000000000000000000001
10000200000000000000002002000000000002000000000001
10000000002000000000000000000200000000002000000001
10000000000000000020000000000000000000002000000001
10000000000000000000000200000000000000000000000001
10000020000000000000000000000200000000000000000001
10000000000000000020000000000000000000000000000001
10000000000000000000000000000000000000000000000001
10000000002000000000000000000200000000200000000001
10000000000000000000000000000000000000000000000001
10000000000000000000000000000000000000000000000001
10002000000000200000000000000000000000000000000001
10000000000000000000001100110000000000000000000001
10000000000000000000000100100000000002000000000001
10000000000000000000001000010000000000000000000001
1000200000020000000001000N001000000000000000000001
10000000000000000000010000001000000000020000000001
10000000000000000000001111110000000000000000000001
10000000000000000000000000000000000000000000000001
10000000020000000000000000000000000000000000000001
10000000000000000000000000000000000000000000000001
10000000000000000000000000000000000000000000000001
10000000000000000000020000000000000000000000000001
10000000000000000000000000000000000000000000000001
10000000000000000000000000000000000000000000000001
10000000000200000000000000000000000200000000000001
10000000000000000000000000000000000000000000000001
10000000000000000000000000000000000000000000000001
10000000000000000000000000000000000000000000000001
10000000000000000000000000000000000000000000000001
10000000000000000000000000000000000000000000000001
10000000000000000000000000000000000000000000000001
10000000000000000000000000000000000000000000000001
11111111111111111111111111111111111111111111111111
