R 1280 720


F 50,110,50
WE ./srcs/Textures/Texture_wall_4.xpm
C 51, 110, 255
S ./srcs/Textures/Texture_lion.xpm
EA ./srcs/Textures/Texture_wall_4.xpm
C_ ./srcs/Textures/Starry_night.xpm

SO ./srcs/Textures/Texture_wall_5.xpm
NO    ./srcs/Textures/Texture_wall_5.xpm

     1111111111111111111111111111111
11111000000000100001000000000000001
10000000000000000000000000000000001
101001000100001000001101111100000201
101001000100001000001000000110000001
101001000100001000001002000111000001
 10100100010000100000100000011110001  
101101111111111111111110111111111111
101101111111111111111112111111111111
101001000100001000001000000111110S01
111011111111111111111101111111102001
100000000001  100000000000000000001
100000000001110000222200000001111111
10000000000000020000000000001
111111111111111111111111111111111111

