R 700 900

F 50, 110, 40 

C 51, 255, 255

EA ./srcs/Textures/Texture_wall_4.xpm
WE  ./srcs/Textures/Texture_wall_4.xpm

S  ./srcs/Textures/Texture_lion.xpm
SO ./srcs/Textures/Texture_wall_5.xpm
NO ./srcs/Textures/Texture_wall_5.xpm

1111111
1000001
1000001
1002001
1000001
100N001
1111111
