R 1280 720


F 50,110,50
WE ./srcs/Textures/Texture_wall_4.xpm
C 51, 110, 255
S ./srcs/Textures/Texture_lion.xpm
EA ./srcs/Textures/Texture_wall_4.xpm
C_ ./srcs/Textures/Starry_night_2.xpm

SO ./srcs/Textures/Texture_wall_5.xpm
NO    ./srcs/Textures/Texture_wall_5.xpm

1111111111111111111111111111111111111111
1000000000000000000000000000000000000001
1000000000000000000000000000000000000001
1000000000000000000000000000000000000001
1000000000000000000000000000000000000001
1000000000000000000000000000000000000001
1000000000000000000000000000000000000001
1000000000000000000000000000000000000001
1000000000000000000000000000000000000001
1000000000000000000E00000000000000000001
1000000000000000000000000000000000000001
1000000000000000000000000000000000000001
1000000000000000000000000000000000000001
1000000000000000000000000000000000000001
1000000000000000000000000000000000000001
1000000000000000000000000000000000000001
1000000000000000000000000000000000000001
1111111111111111111111111111111111111111
